NO ./path_to_the_north_texture.xpm
SO ./path_to_the_south_texture.xpm
WE ./path_to_the_west_texture.xpm
EA ./path_to_the_east_texture.xpm

F 220,100,10
C 225,300,10

  111111
  100001                                              1111111111111
  10000111111111                                      1000000000001
  10000000000001111111                   11111111111111000000000001
  1000000000000100000111111111111    111110000000000000000000000001
  10000000000001000000000000000011111100010000000000000000000000001
1111000000000000000000000000000000000000010000000000000000000000001111
10000000000000010000000W0000000000000000000000000000000000000000000001
1000000000000001000000000000000000000000010000000000000000000000000001
1100000000000001111111111111101111111111110000011111111111100000000001
1100000000000011            101          1000001          100000000011
111100111000111  1111111111110111 111111 1000001          100000001111
1111001111111    1000000000000001110000111000001          100000001
110000000011111111000000000000000000000000000001          100000001
1100000000000000000001111111110000011111111111111111111111100000001
1100000000000000000001       1000001         1000000000000000000001111
1111111000001111111111       1000001         1000000000000000000000001
     11111011111           111000001         1000000000000000000000001
   11100000000011          100000001         1000001110000000000000001
   100000000000011       111000000011111111111000001 10000000000000001
   100000000000001       100000000000000000000000001 10000000000000001
   100000000000001       110000011111110000000100001 10000010000000001
   100000000000001        1111011     10000000000001 11111111111111111
  1100000000000111           1011     10000000000001
  1000000000000111111111     101      10000000000001
 11000000000000000000001     1011    110000000000001
 110000000000000000000011111110011111100000011111111
11000000000000000000000000000000000000000000111
10000000000000000000000000000000000000000000001
10000000000000000000000000000000000000000000001
10000000000000000000000000000000000000000000001
11111111111111111111111111111111111111111111111