NO ./assets/textures/brick_green.xpm
SO ./assets/textures/brick_purple.xpm
WE ./assets/textures/brick_yellow.xpm
EA ./assets/textures/brick_blue.xpm

F 0,0,0
C 0,0,0

1111111111111111111111
1000010000000011000001
1101111110011000001001
100000E000000001111001
1111000110101001000001
1111000110101001000001
1100000000101011110001
1000000110000000000001
1000000000101001000001
1111111111111111111111