NO ./assets/textures/brick_green.xpm
SO ./assets/textures/brick_purple.xpm
WE ./assets/textures/brick_yellow.xpm
EA ./assets/textures/brick_blue.xpm

F 0,0,0
C 0,0,0

11111111111111111111
10000100000000110001
11011111101100000001
100000E0000000011111
11110101101000010001
11110101101010010001
11000000001010111001
10000001100000000001
10000000001010010001
11111111111111111111